111111111111
100001111111
10CE01111111
101P11111111
111111111011
