1111111111111111111111111111111111111111111111111111111
1000000000000000000000000000000000000000000000000000001
1000000000000000000000000000000000000000000000000000001
1000000000000000000000000000000000000000000000000000001
1000000000000000000000000000000000000000000000000000001
1000000000000000000000000000000000000000000000000000001
1000000000000000000000000000000000000000000000000000001
1000000000000000000000000000000000000000000000000000001
1000000000000000000000000000000000000000000000000000001
1000000000000000000000000000000000000000000000000000001
1000000000000000000000000000000000000000000000000000001
1000000000000XXXXX0000000000000000000000000000000000001
10000000000000XXX00000000000000000000000000000000000001
10000000000000XXX00000000000000000000000000000000000001
1000000000000000000000000000000000000000000000000000001
1000000000000000000000000000000000000000000000000000001
100000X000000000000000000000000000000000X00000000000001
1001000000001000000000000000000000000000000000000000001
1XXXXX0000001000000000000010000000000000000000000000001
1P0ECX0000001000000000000010000000000000000000000000001
100000000000100000000000001000000000000000000000000X001
1000000000001111111100000010000000000000000000000000001
1000000000001000000111111110000000000000000000000000001
1000000000001000000100000000000000000000000000000000001
1000000000011000000000000000000000000000000000000000001
1000000000010000000100000000000000000000000000000000001
1110111111110000000100000000000000000000000000000000001
1000000000000000000000000000000000000000000000000000001
1111111111111111111111111111111111111111111111111111111