111111111111111111111111
1P00000C0000000010000C01
100000001000011111110001
1110X0111110010E00010001
10000000000C000000000X01
111111111111111111111111