1111111111111111111111111111111111111
1000P00000000000000000000000000000001
100000000000000CCC000000000000000X001
100000000000000CEC0000000000000000001
100000000000000CCC0000000000000000001
1000000000000000000000000000000000001
1111111111111111111111111111111111111