1111111111111111111111111111111111111
111111111111111P000000011111E11111111
1111111111111111111111011111011111111
1111111111111111111111011111011111111
1111111111111111111111011111011111111
1111111111111111111111011111011111111
1111111111111111111111011111011111111
1111111111111111000000000000011111111
1111111111111111011111011111111111111
1111111111111111011111011111111111111
1111111111111111011111011111111111111
1111111111111111011111011111111111111
1111111111111111011111011111111111111
1111111111111111C11111000000X11111111
1111111111111111111111111111111111111
1111111111111111111111111111111111111
1111111111111111111111111111111111111
1111111111111111111111111111111111111
1111111111111111111111111111111111111
1111111111111111111111111111111111111
1111111111111111111111111111111111111
1111111111111111111111111111111111111
1111111111111111111111111111111111111
1111111111111111111111111111111111111
1111111111111111111111111111111111111
1111111111111111111111111111111111111