1111111111111111111111111111111111111
1111111111111100000000001111E11111111
1111111111111101111111011111P11111111
1111111111111101111111011111011111111
11111111111111X1111111011111011111111
1111111111111101111111011111011111111
11111111111111X1111111011111011111111
1111111111111101000000000000011111111
1111111111111111011111011111111111111
11111111111111X1011111011111111111111
1111111111111111011111011111111111111
1111111111111111011111011111111111111
1111111111111111011111011111111111111
1111111111111111C11111000000X11111111
1111111111111111111111111111111111111
1111111111111111111111111111111111111
1111111111111111111111111111111111111
1111111111111111111111111111111111111
1111111111111111111111111111111111111
1111111111111111111111111111111111111
1111111111111111111111111111111111111
1111111111111111111111111111111111111
1111111111111111111111111111111111111
1111111111111111111111111111111111111
1111111111111111111111111111111111111
1111111111111111111111111111111111111