1111111111111111111111111111111111111111111111111111111
1000000000000000000001000000000000000000000000000000001
10CCC00000000000000001000000000000000000000000000000001
10CCC00000000000000001000000000000000000000000000000001
1000000000000000000001111111111111111111111111100000001
1001001111110000000001000000000000000000100000000000001
1001000010010000000001000000000000000000100000000000001
1001000010011111111111111111111110000000111111111100001
1001000010010000000000000000000000000000100000000000001
1E00000000000000000000000000000000000000100000000000001
1111111111111111111100000000000000000000100000000000001
1PC0000000000000000000000000000000000000000000000000001
1111111111111111111111111111111111111111111111111111111