1111111111111111111111111111111111111111111111111111111
1P00000000000000000000000000001000000000000X00000000001
1011111110C10111111111111101111011111111100011111111111
10000000000100000000000000000010000000000000000C0000001
1011111111111111111111111111111011111111111111111111111
100000000000000000000X000000000000000000000000000000001
1011111111111110001111111111111111111111111101111111111
1000000000000000000000000000000000000000C00000000000001
1111111111000000011111111111111111100111111111110111111
10000000000000000000000X0000X00000000000000000000000001
1111111111111111111111111111111111111111111110111111111
1000000000000C010000X0000000X00000000000000000000000001
1011111111111111111111110000000000000111111111111111111
1000C0000000000000000000000000X0000000000C0000000000001
1011111111111111111111111111111111111111111111111111111
1000000000000000000000000000000000000000000000000000001
1011111111111111111111111111111111111111111111111111111
1000000000000000000000000000000000000000000000000000001
1111111111101111111111111111111111011111111111111111111
1000000000000000000000X00000000000000000000000000000001
1011111111111111111111111111111111111110111111111111111
1000000000000000000000000000000000000000C00000000000001
1011111111111111111111111111111111111111111111111111111
1000000000000000000000000000000000000000000000000000001
1011111111111111111111111111111111111111111111111111111
10000000000000000000X0000000000000000000000000000000001
10111111111111100X0011111101111111111111111111111111111
100000C00000000000E000000000000000000000000000000000001
1111111111111111111111111111111111111111111111111111111