1111111111111111111111111111111111111111111111111111111
1000000000000000000000000000000000000000000000000000001
1000000000000000000000000000000000000000000000000000001
1000000000000000000000000000000000000000000000000000001
1000000000000000000000000000000000000000000000000000001
1000000000000000000000000000000000000000000000000000001
1000000000000000000000000000000000000000000000000000001
1000000000000000000000000000000000000000000000000000001
1000000000000000000000000000000000000000000000000000001
1000000000000000111111111000000000000000000000000000001
1000000000000000110X00001000000000000000000000000000001
10000000000000001111X1111000000000000000000000000000001
1000000000000000000010000000000000000000000000000000001
1000000000000000000000000000000000000000000000000000001
1000000000000000000000000000000000000000000000000000001
1000000000000000000000000000000000000000000000000000001
1000000000000000000000000000000000000000000000000000001
1001000000001000000000000000000000000000000000000000001
1000000000001000000000000010000000000000000000000000001
1P0EC00000001000000000000010000000000000000000000000001
1000000000001000000000000010000000000000000000000000001
10000000000011111111000000100000000000000000001
1000000000001000000111111110000000000000000000000000001
1000000000001000000100000000000000000000000000000000001
1000000000011000000000000000000000000000000000000000001
1000000000010000000100000000000000000000000000000000001
1110111111110000000100000000000000000000000000000000001
1000000000000000000000000000000000000000000000000000001
1111111111111111111111111111111111111111111111111111111