1111111111111111111111111111
100000000000000000000X0X0001
100101111111100C000000000001
1P00001001000000000000000001
100000X001000000000000010001
10000000C1000000E00000010001
1000000001000X00000000010001
1001111111111111000111111111
1001000000000000000000100001
10000000000X0000000000000C01
1C0100000C000010000000100001
1000000000000010000000000001
10000000000000100000000X0001
1111111111111111111111111111