11111111111111111111111111111111
11011000110000111111011111010111
11001111100110001001001001C11101
111010000000111000010010X1010101
10101110110110101101011010010111
1110000010010010000X110011010001
110011101111101001000110010X0101
10010000000000110111000001000111
101100111111110X0001111101110011
10001110000000011100000100011011
11101010101111100010111101000011
1010001110X010000110001001101011
11101000011010111100011001001111
11001001110011100001110111000101
1110101000000000011100000X0X1101
10101010111111101101101111010011
11111010001000100000100010010011
11010011101110111110101110110011
10010100100010000011100100100111
11110X00011011011000011111111101
11000100001000110010010000000111
11110011101110011011110111100011
11010000100010001100001100101111
110101101110X010011011X000101001
1100E000101111010P00000101001111
11111111111111111111111111111111