111111111111111111111111111
1E0000000000000C00000C00001
101001010010000010100100001
101001001010101000100100001
1P0000000C00C00000000000001
1XXXXXXXXXXXXXXXXXXXXXXXXX1
1XXXXXXXXXXXXXXXXXXXXXXXXX1
1XXXXXXXXXXXXXXXXXXXXXXXXX1
1XXXXXXXXXXXXXXXXXXXXXXXXX1
100000000000000000C00000001
100000C00000010000000000001
100000000000010000000000001
100000000000010000000000001
1000000000000000C0000000001
100000000000000000000000001
111111111111111111111111111