1111111111111111111111111111111111111111111111
1111111111111111111111111111111111111111111111
1111111P000000000000C00000000000000000000XEX11
11111110011111111111111111111111111111111XXX11
1111111001111111111111111111111111111111100011
1111111111111111111111111111111111111111111111