111111111111111111111111111
1000000000000000000000000C1
100000000000000000000000001
100000000000000000000000001
100000000000000000000000001
100000000000X00000000000001
10000000000XXX0000000000001
100000000000X00000000000001
100000000000000000000000001
100000000000000000000000001
100000000000000000000000001
10000P0000000000000000000E1
111111111111111111111111111