111111
1XC001
100E11
1P0C01
111111