11111111111111111111111111111111111111111
1000P00C0000000E0000000000000000000000001
10011100001100001000001000011000010000101
10001000100001001100011001000010011000101
10001000100001001010101001000010010100101
10001000111111001001001001111110010010101
10001000100001001000001001000010010001101
10011100100001001000001001000010010000101
10000000000000000000000000000000000000001
11111111111111111111111111111111111111111