11111111111111111
1000C00000C000001
1E0000000C0000001
1000000P000000001
11111111111111111