11111111111111111
10000000000000001
1E000000000C00001
1P000000000000001
11111111111111111
