11111111111111111111111111111111111111111
1X00C00000C000000000000000000010000000XX1
1000C00000C000000000000000000011111111111
1000C00000C000000000000000000000000000001
1000C00000C000000000000000000000000000001
1000C00000C000000000000000000000000000001
1000C00000C000000000000000000000000000001
1000C00000C000000000000000000000000000001
1000C00000C000000000000000000000000000001
1000C00000C000000000000000000000000000001
1000C00000C000000000000000000000000000001
1000C00000C000000000000XXXXX0000000000001
1000C00000C000000000000000000000000000001
1000C00000C0000000000000XXXX0000000000001
1000C00000C000000000000000000000000000001
1000C00000C000000000000000000000000000001
1000C00000C0000000000000000X0000000000001
1000C00000C000000000000000000000000000001
1E0000000C0000000000000000000000000000001
1000000P000000000000000000000000000000X01
11111111111111111111111111111111111111111