111111111111
1C0001111111
1110C1111111
100P1E111111
111111111111