11111111111111111111111111111111111111111
1000C00000C000000000000000000000000000001
1000C00000C000000000000000000000000000001
1000C00000C000000000000000000000000000001
1000C00000C000000000000000000000000000001
1000C00000C000000000000000000000000000001
1000C00000C000000000000000000000000000001
1000C00000C000000000000000000000000000001
1000C00000C000000000000000000000000000001
1000C00000C000000000000000000000000000001
1000C00000C000000000000000000000000000001
1000C00000C000000000000000000000000000001
1000C00000C000000000000000000000000000001
1000C00000C000000000000000000000000000001
1000C00000C000000000000000000000000000001
1000C00000C000000000000000000000000000001
1000C00000C000000000000000000000000000001
1000C00000C000000000000000000000000000001
1E0000000C0000000000000000000000000000001
1000000P000000000000000000000000000000001
11111111111111111111111111111111111111111