11111111111111111111111111111111111111111
1X00C00000C0000000000000000000100000X0001
1000C00000C000000000000000000011111X11111
1000C00000C000000000000000000000001010001
1000C00000C000000000000000000000001010001
1000C00000C000000000000000000000000100001
1000C00000C000000000000000000000000000001
1000C00000C000000000000000000000000000001
1000C00000C000000000000000000000000000001
1000C00000C000000000000000000000000000001
1000C00000C000000000000000000000000000001
1000C00000C000000000000000000000000000001
1000C00000C000000000000000000000000000001
1000C00000C0000000000000X0000000000000001
1000C00000C000000000000000000000000000001
1000C00000C000000000000000000000000000001
1000C00000C000000000000000000000000000001
1000C00000C000000000000000000000000000001
1E0000000C0000000000000000000000000000001
1000000P000000000000000000000000000000X01
11111111111111111111111111111111111111111