1111111111111111111111111111
1P000000C00000C0000000000E01
10000000000C00C0000000000001
1111111111111111111111111111
