111111111111111111111111
100000000C00000000000001
1P0000000000000000000001
100000000E00000000000001
111111111111111111111111