111111111111111
1P00000C0000001
101011111000001
100010001000001
111010101011111
10C000100000001
101X10101111101
101000C01010001
101011101011101
10000X000E00001
111111111111111
