11111111111
1P00000C001
10101111101
10001000101
11101010101
10C00010X01
10101010111
1010X0C0101
10101110101
100X00000E1
11111111111
