11111111111
1P00000CX01
10101111101
10001000101
11101010101
10C00010001
101X1010111
101000C0101
10101110101
10000X000E1
11111111111
