11111111111111111111111111111111111
1P000000000C1000000010000000C000011
11111110000011100001111100100001111
10000010000000000000000000000000001
100X0010000000000000000000000000001
10000010000011110011110001000000001
10001111011110000000010001000000001
10000000000000001111110001111100001
100000100000000000000100010000X0001
100000111111110000X0000001000000001
10000000010000000000000111111100001
100C000001000000C0000000000100X0001
10000000010000000000000000E10000001
11111111111111111111111111111111111
